 A A A A A A A A A A A A A A A A A A A A A A A A A A A A A A A A A A A A A A A A A A A A A A A A A A A A A A A A A A A A A A A A A A A A A A A A A A A A A A A A A A A A A A A A A A A A A A A A A A A A A A A A A A A A 
 A A A A A A A A A A A A A A A A A A A A A A A A A A A A A A A A A A A A A A A A A A A A A A A A A A A A A A A A A A A A A A A A A A A A A A A A A A A A A A A A A A A A A A A A A A A A A A A A A A A A A A A A A A A A 
 A A A A A A A A A A A A A A A A A A A A A A A A A A A A A A A A A A A A A A A A A A A A A A A A A A A A A A A A A A A A A A A A A A A A A A A A A A A A A A A A A A A A A A A A A A A A A A A A A A A A A A A A A A A A 
 A A A A A A A A A A A A A A A A A A A A A A A A A A A A A A A A A A A A A A A A A A A A A A A A A A A A A A A A A A A A A A A A A A A A A A A A A A A A A A A A A A A A A A A A A A A A A A A A A A A A A A A A A A A A 
 A A A A B B B B B B B B B B B B B B B B B B B B B B B B B B B B B B B B B B B B B B B B B B B B B B B B B B B B B B B B B B B B B B B B B B B B B B B B B B B B B B B B B B B B B B B B B B B B B B B B B B B B A A A A 
 A A A B B B B B B B B B B B B B B B B B B B B B B B B B B B B B B B B B B B B B B B B B B B B B B B B B B B B B B B B B B B B B B B B B B B B B B B B B B B B B B B B B B B B B B B B B B B B B B B B B B B B B B A A A 
 A A A B B B B B B B B B B B B B B B B B B B B B B B B B B B B B B B B B B B B B B B B B B B B B B B B B B B B B B B B B B B B B B B B B B B B B B B B B B B B B B B B B B B B B B B B B B B B B B B B B B B B B B A A A 
 A A A B B B B B B B B B B B B B B B B B B B B B B B B B B B B B B B B B B B B B B B B B B B B B B B B B B B B B B B B B B B B B B B B B B B B B B B B B B B B B B B B B B B B B B B B B B B B B B B B B B B B B B A A A 
 A A A B B B B B B B B B B B B B B B B B B B B B B B B B B B B B B B B B B B B B B B B B B B B B B B B B B B B B B B B B B B B B B B B B B B B B B B B B B B B B B B B B B B B B B B B B B B B B B B B B B B B B B A A A 
 A A A B B B B B B B B B B B B B B B B B B B B B B B B B B B C B B B B B B B B B B B B B B B B B B B B B B B B B B B B B B B B B B B B B B B B B B B B B B B B B B B B B B B B B B B B B B B B B B B B B B B B B B A A A 
 A A A B B B B B B B B B B B B B B B B B B B B B B B B B B B C B B B B B B B B B B B B B B B B B B B B B B B B B B B B B B B B B B B B B B B B B B B B B B B B B B B B B B B B B B B B B B B B B B B B B B B B B B A A A 
 A A A B B B B B B B B B B B B B B B B B B B B B B B B B B B B C B B B B B B B B B B B B B B B B B B B B B B R B B B B B B B B R B B B B B B B B B B B B B B B B B B B B B B B B B B B B B B B B B B B B B B B B B A A A 
 A A A B B B B B B B B B B B B B B B B B B B B B B B B B B B B C B B B B B B C B B B B B B B B B B B B B B B B B B B B B B B C B B B B B R R B B B B B B B B B B C B B B B B R R B B B B B B B B B B B B B B B B B A A A 
 A A A B B B B B B B B B B B B B B B B B B B B B B B B B B B C C B B B B B C B B B B B B B B B B B B B B B B B B B B B B B B C B B B B B R R B B B B B B B B B C B B B B B B B B B B B B B B B B B B B B B B B B B A A A 
 A A A B B B B B B B B B B B B B B B B B B B B B B B B B B B C C B B B B B C B B B B B B B B B B B B B B B B B B B B B B C C C B B B B B B B B B B B B B B B C B B B B B B B B B B B B B B B B B B B B B B B B B B A A A 
 A A A B B B B B B B B B B B B B R B B C B B B B B C B B B B B B C B B B C B B B B B B B B B B B B B B B B B B B B B C C C C C B B B B B B B B B B B B B B C B B B B B B C B B B B B B B B B B B B B B B B B B B B A A A 
 A A A B B B B B B B B B B B B B R B B C B B B B B C B B B B B B C B B B C B C B B B B B B B C B B B B B B B B C C B C C C C B B B B B B B B B B B B B B C C B B B B C C C B B B B B B B B B B B B B B B B B B B B A A A 
 A A A B B B B B B B B B B B B B B B B C C B B B B C B B B B B C C B B B C C B B B B B B B B B C B B B B B B C C C B C C C C B B B B B B B B B B B C C C C C B B B B C C C B B B B B B B B B B B R B B B B B B B B A A A 
 A A A B B B B B B B B B B B B B B B B C C B B B B C C C B B C C C B B C C C B B B B B B B B B C B B B B B C C C C B C C C C B B B B B B B B B B B C C C C C B B B C C C C B B B B B B B B B B R R R B B B B B B B A A A 
 A A A B B B B B B B B B B B B B B B B C C B B B B B C C B B C C C B B C C C B B B B B B B C B C B B B B C C C C C C C C C C B B B B B C B B B B C C C C C C B B B C C C B B B B B B B B B B B B R B B B B B B B B A A A 
 A A A B B B C B B B B B B B B B B B B C C C C B C C C C B B C C C B B C C C C B B B B B B B C C B B B B C C C C C C C C C C B B B C C B B B C C C C C C C B B B C C C C B B B B B B B B B B B B B B B B B B B B B A A A 
 A A A B B B B C B B B B B B B B C B B C C C C B C C C C B B C C C B B C C C C B B B B B B C C C B B B B C C C C C C C C C C B B B C B B B B C C C C C C C B B B C C C C B B B C B B B B B B B B B B B B B B B B B A A A 
 A A A B B B B C B B B B B B B B C B B C C C C B C C C C B B C C C B B C C C C B B C C B B C C C B B C C C C C C C C C C C C C B C C B B B C C C C C C C C B B C C C C C B B B C C C B B B B B B B B B B B B B B B A A A 
 A A A B B B B B C B B B B B B C B B B B B C C B C C C C B B C C C B B C C C C B B C C C C C C C B B C C C C C C C C C C C C C B C C B C C C C C C C C B B B C C C C C B B B B C C C B B B B B B B B B B B R R B B A A A 
 A A A B B B B B C C B B B B B C B B B B B C C C C C C C B C C C C B B C C C C C B C C C C C C C B C C C C C C C C C C C C C C C C C C C C C C C C C B B B C C C C C C B B B B C C C B B B B B B B B B B B B B B B A A A 
 A A A B B B B B B C C B B B B C B B B B B C C C C C C C B C C C C C B C C C C C B C C C C C C C C C C C C C C C C C C C C C C C C C C C C C C C C C B B B C C C C C C B B B B C C C B B B B C C B B B B B B B B B A A A 
 A A A C C B B B B C C C B B B C B B B B B C C C C C C C C C C C C C C C C C C C C C C C C C C C C C C C C C C C C C E C C C C C C C C C C C C C C C C C C C C C C C C B B B B C C C B B B C C C B B B C C B B C C A A A 
 A A A C C B B B C C C C C C C C B B B B C C C C C C C C C C C C C C C C C C C C C C C C C C C C C C C C C C C C C E N E C C C C C C C C C C C C C C C C C C C C C C C B B B B C C C B B C C C C B B C C C B B C C A A A 
 A A A C C B B B B B C C C C C C B B B B C C C C C C C C C C C C C C C C C C C C C C C C C C C C C C C C C C C C C N N E C C C C C C C C C C C C C C C C C C C C C C C B B B B C C B B B C C C C B B C C C B B C C A A A 
 A A A C C C B B B B B C C C C C C C B B C C C C C C C C C C C C R C C C C C C C C C C C C C C C C C C C C C C C E F N E C C C C C C C C C C C C C C C C C C C C C C C B C B C C C B B C C C B B C C C C C B C C C A A A 
 A A A C C C C C B B B B C C C C C C B C C C C C C C C C C C C R R R C C C C C C C C C C C C C C C C C C C C C E F F N E C C C C C C C C C C C C C C R C C C C C C C C C C C C C C B C C C B B C C C C C C B C C C A A A 
 A A A C C C C C C B B B B B C C C C C C C C C C C C C C C C C C R C C C C C C C C C C C C C C C C C C C C C E F F F N E C C C C C C C C C C C C C C C C C C C C C C C C C C C C C C C C C B B C C C C C C C C C C A A A 
 A A A C C C C C C B B B B B C C C C C C C C C C C C C C C C C C C C C C C D D D D C C C C C C C C C C C C E F F F F N E C C C C C C C C C C C C C C C C C C C C C C C C C C C C C C C C C B B C C C C C C C C C C A A A 
 A A A C C C C C C C C C B B C C C C C C C C C C C C C C C C C C C C C C C D D D D C C C C D D C C C C C C E F F F F N E C C C C C C C C E E E E E E E E E C C C C C C C C C C C C C C C C B C C C C C C C C C B B A A A 
 A A A C C C C C C C C C C C C C C C C C C C C C C C C C D D C C C C C C C D D D D D C C C C D D D D D D E F F F F F N E C C C E E E E E G G G G G G G G G E E E E C C C C C C C C C C C C C C C C C C C C C B B B A A A 
 A A A C C C C C C C C C C C C C C C C C C C C C C C C D D D C C C C C C D D D D D D C C C C D D D D D D E F F F F F N E C C C E G G G G G E E E E E E E E G G G G E E C C C C C C C C C C C C C C C C C C B B B B A A A 
 A A A B C C C C C C C C C C C C D D D D C C C C C C C D D D D C C C C C D D D D D D C C C D D D D D D E F F F F F F N E E E E E G G E E E E E E E E E E E G G G E E E E C C C C C C C C C C C C C C C C C B B B B A A A 
 A A A B C C C C C C C C C C C C D D D D C C C C C C C D D D D D C C C C D D D D C C D C C C C C C C E F F F F F F F N E E E E E E E E E E E E E E E E E E E E G G G E E C C C C C C C C C C C C C C C C B B B B B A A A 
 A A A B C C C C C C C C C C C C C D D D C C C C D D C D D D D D C C D D D D D D D D D D D D D D D E F F F F F F F F N E E E E E E E E E E D D D D D D D D E E E G G G E E C C C C C C C C C C C C C C C B B C C C A A A 
 A A A B C C C C C C C C C C C C C D D D C C C C D D D D D D D D C D D D D D D D D D D D D D D D D E F F F F F F F F N E E E E E E E E D D D D D D D D D D D D E E G G G G E E C C C C C C C C C C C C C B C C C C A A A
 A A A C C C C C C C C C C C C C C D D D D C C D D D D D D D D D D D D D D D D D D D D D D D D D E F F F F F F F F F N N E E E E D D D D D D D D D E D D D D D D E E E G G E E E C C C C C C C C C C C C C C C C C A A A 
 A A A C C C C C C C C C C C C C C D D D D D D D D D D D D D D D D D D D D D D D D D D D D D D D E F F F F F F F F F N N E E D D D D D D D D D E E E D D D D D D D E E E G G E E E C C C C C C C C C C C C C C C C A A A 
 A A A C C C C C C C C C C C C C C D D D D D D D D D D D D D D D D D D D D E E E E E E E E E D E F F F F F F F F F F N N E E D D D D D D E E E F F E D D D D D D D D E E E G G E E E C C C C C C C C C C C C C C C A A A 
 A A A C C C C C C C C C C C C C C D D D D D D D D D D D D D D D D D D E E E E E E E E E E E E E F F F F F F F F F F N N E E D E D D D E F F F F F E D D D D D D D D D D E E G G E E C C C C C C C C C C C C C C C A A A 
 A A A C C E E E E C C C C E E E E D D D D D D D D D D D D D D D D E E G G G G E E G G E E E E F F F F F F F F F F F N N E E E E D E E F F F F N E D D D D D D D D D D D D E E E E E E D D D C C C C C C C C C C C A A A 
 A A A C C E N N N E C C E N N N E D D D D D D D D D D D D D D D E G G G G G E E G G E E E E E F F F F F F F F F F F N N N N E E E F F F F F F E D D D D D D D D D D D D D D E E G E E D D D C C C C C C C C C C C A A A 
 A A A C C E N Q Q Q Q Q Q Q Q N E D D D D D D D D D D D D D D D E G G G G E G G G E E E E E F F F F F F F F F F F F N F F N E E F F F F F F E D D D D D D D E E E D D D D D D E G E E E D D C C C C C E E E E E C A A A 
 A A A C C E N N Q Q Q Q Q Q N N E D D D D D D D D D D D D D D E G G G G E G G G E E E E E F F F F F F F F F F F F N F F F N E F F F F F F F E D D D D E E E F E E D D D D D D E G E E E E E E E E E E F F F E E C A A A 
 A A A D D D E N Q Q Q Q Q Q N E D D D D D D D D D D D D D D E G G G G E G G G E E E E F F F F F F F F F F F F F F F F F F F F F F F F F F N E D D E E F F F E E D D D D E E E E E G E E E F F F F F F F F N E C C A A A 
 A A A D D D D E N Q Q Q Q N E D D D D D D D D D D D D D D E G G G G E G G G E E E E F F F F F F F F F F F F F F F F F F F F F F F N N N N N E E E F F F F N E D D D E E E F F F F G E E E F F F F F F N N E C C C A A A 
 A A A D D D D E N Q Q Q Q N E D D D D D D D D D D D D D D E G G G G E G G E E E F F F F F F F F F F F F F F F F F F F F F F F F F F F F F F F F F F N N N E D E E E F F F F F F F E G E E F F F F F N N E D D C C A A A 
 A A A D D D E N Q Q Q Q Q Q N E D D D D D D D D D D D D D E G E G E G G E E E F E F F F F F F F F F F F F F F F F F F F F F F F F F F F F F F F F F F N N E E F F F F F F F F F F E G E E F F F F N N N E D D D C A A A 
 A A A D D D E N Q Q Q Q Q Q N E D D D D D D D D D D D D D E E G E E G E F F F F E E F F F F F F F F F F F F F F F F F F F F F F F F F F F F F F F F N E E F F F F F F F F F F F F E G E E F F N N N E E D D D D D A A A 
 A A A D D E E N N N N N N N N E E D D D D D D D D D D D E E E G E E E F F F F E I E F F F F F F F F F F F F F F F F F F F F F F F F F F F F F F E F F F F F F F F F F F F F F F F E G E E E N N N N E D D D D D D A A A 
 A A A D D E E N N N N N N N N E E D D D D D D D D D D D E E E G E E F F F F F E I I I F F F F F F F F F F F F F F F F F F F F F F F F F F F F F F F F F F F F F F F F F F F F F F E G E E E N N N E D D D D D D D A A A 
 A A A D D D D E E E E E E E E D D D D D D D D D D D E E E E E E E F F F F F E H I I I E F F F F F F F F F F F F F F F F F F F F F F F F F F F F F F F F F F F F F F F F F F F F F E G E E E N N E D D D D D D D D A A A 
 A A A D D D D D D D D D D D D D D D D D D D D D E E F F E E E F F F F F F F E H H H H E F F F F F F F F F F F F F F F F F F F F F F F F F F F F F F F F F F F F F F F F F F F N N E G E E E E E D D D D D D D D D A A A 
 A A A D D D D D D D D D D D D D D D D D D D E E F F F F E E F F F F F F F E I H H H H E F F F F F F F F F F F F F F F F F F F F F F F F F F F F F F F F F F F F F F F F F F N N N E G E E E E D D D D D D D D D D A A A 
 A A A C C D D D D D D D D D D D D D D D D E F F F F F F E E F F F F F F F E I H H H H I E F F F F F F F F F F F F F F F F F F F F F F F F F F F F F F F F F F F F F F F F N N N N E E E E E E D D D D D D D D D D A A A 
 A A A C C D D D D D D D D D D D D D D D E F F F F F F F E F F F F F F F F E I H H H H I E F F F F F F F F F F F F F F F F F F F F F F F F F F F F F F F F F F F F F F N N E E E E E E E E E D D D D D D D D D D D A A A 
 A A A D D D D D D D D D D D D D D D E N E F F F F F F E F F F F F F F F F E I H H H H H I E F F F F F F F F F F F F F F F F F F F F F F F F F F F F F F F F F F F F N E E K K K E E E E E E D D D D D D D D D D D A A A 
 A A A D D D D D D D D D D D D D D E N N F F F F F F E E F F F F E F F F F E I H H H H H I E F F F F F F F F F F F F F F F F F F F F F F F F F F F F F F F F F F F E E E K K K K E E E E E E E D D D D D D D D D D A A A 
 A A A D D D D D D D D D D D D D D E N N F F F F F F E F F F F E E F F F F E I H H H H H H I E F E F F F F F F F F F F F F F F F F F F F F F F F F F F F F F F F F E K K K K K E E E E E E E E E D D D D D D D D D A A A 
 A A A D D D D D D D D D D D D D D E N N N N F F F E E F F F F E J E F F F F E H H H H H H I E N E F F F F F F F F F F F F F F F F F F F F F F E E F F F F F F F E K K K A K K E E E E E E E E E E D D D D D D D D A A A 
 A A A D D D D D D D D D D D D D D E N N N N F F F E F F F F F E J E F F F F E H H H H H I I E E F F F F F F F F F F F F F F F F F F F E E E E E E F F F F F F E K K K A A A K K E E E E E E E E E E E E E E D D D A A A 
 A A A D D D D D D D D D D D D D D E N N N N N N E F F F F F F E J J E F F F F E I H H H I I E F F F F F F F F F F F F F F F F E E E E I I I I I E F F F F F F E K A A A A A K K E E E E E E E E E E E E D D D D D A A A 
 A A A D D D D D D D D D D D D D D E N N N N N N E F F F F F E J J J J E F F F F E E I I I E F F F F F F F F E E E E E E E E I I I H H H H H I E F F F F F F E K K A A A A A K K E E E E E E E E E E E E D D D D D A A A 
 A A A D D D D D D D D D D D D D D D E N N N N E F F F F F F E J J J J E F F F F F F E E F F F F F F F F F E E I E I I I I E H H H H H H H H I E F F F F F F E K A A A A A A K E E L L L L L L E E E P P P P P P P A A A 
 A A A D D D D D D D D D D D D D D D E N N N E F F F F F F F E J J J E J E F F F F F F F F F F F F F F F F F E I E H H H H H H H H H H H H H E F F F F F F E K K A K K A A K E E L L L M M M M E E E P P P P P P P A A A 
 A A A D D D D D D D D D D D D D D D D E N N E F F F F F F F E J J J E J J E E F F F F F F F F F F F F F F F E I H H H H H H H H H H H H I E F F F F F F F E K K L A K K A A K E E M L M L L L L M L L P P P P P P P A A A
 A A A D D D D D D D D D D D D D D D D E E N E F F F F F F F E J J E J J J J J E E F F F F F F F F F F F F F E I H H H H H H H H H H H E E F F F F F F F F E K K A K K A E E E M M L M L L L L M L E P P P P P P P A A A 
 A A A D D D D D D D D D D D D D D D D E E E F F F F F F F F E J J E J J J J J J E F F F F F F F F F F F F F E I I H H H H H H H H H E F F F F F F F F F F E K K A K K A K E E M L L M L L L L M L E P P P P P P P A A A 
 A A A D D E E D D E E D D D D D D D D D D E F F F F F F F F E J E E J J J J J J E E E F F F F F F F F F F F F E E E I I I I I I E F F F F F F F F F F F F E K K K K K K K E E M L L M L L L L M L L P P P P P P P A A A 
 A A A D D E R D D E R D D D D D D D D E E F F F F F F F F F F E E J J J J J J J E J J E F F F F F F F F F F F F F F E E E E E E F F F F F F F F F F F F F E K E K K K K E E E M L L M L L L L M L L P P P P P P P A A A