 A A A A A A A A A A A A A A A A A A A A A A A A A A A A A A A A A A A A A A A A A A A A A A A A A A A A A A A A A A A A A A A A A A A A A A A A A A A A A A A A A A A A A A A A A A A A A A A A A A A A A A A A A A A A 
 A A A A A A A A A A A A A A A A A A A A A A A A A A A A A A A A A A A A A A A A A A A A A A A A A A A A A A A A A A A A A A A A A A A A A A A A A A A A A A A A A A A A A A A A A A A A A A A A A A A A A A A A A A A A 
 A A A A A A A A A A A A A A A A A A A A A A A A A A A A A A A A A A A A A A A A A A A A A A A A A A A A A A A A A A A A A A A A A A A A A A A A A A A A A A A A A A A A A A A A A A A A A A A A A A A A A A A A A A A A 
 A A A A A A A A A A A A A A A A A A A A A A A A A A A A A A A A A A A A A A A A A A A A A A A A A A A A A A A A A A A A A A A A A A A A A A A A A A A A A A A A A A A A A A A A A A A A A A A A A A A A A A A A A A A A 
 A A A A B B B B B B B B B B B B B B B B B B B B B B B B B B B B B B B B B B B B B B B B B B B B B B B B B B B B B B B B B B B B B B B B B B B B B B B B B B B B B B B B B B B B B B B B B B B B B B B B B B B B A A A A 
 A A A B B B B B B B B B B B B B B B B B B B B B B B B B B B B B B B B B B B B B B B B B B B B B B B B B B B B B B B B B B B B B B B B B B B B B B B B B B B B B B B B B B B B B B B B B B B B B B B B B B B B B B A A A 
 A A A B B B B B B B B B B B B B B B B B B B B B B B B B B B B B B B B B B B B B B B B B B B B B B B B B B B B B B B B B B B B B B B B B B B B B B B B B B B B B B B B B B B B B B B B B B B B B B B B B B B B B B A A A 
 A A A B B B B B B B B B B B B B B B B B B B B B B B B B B B B B B B B B B B B B B B B B B B B B B B B B B B B B B B B B B B B B B B B B B B B B B B B B B B B B B B B B B B B B B B B B B B B B B B B B B B B B B A A A 
 A A A B B B B B B B B B B B B B B B B B B B B B B B B B B B B B B B B B B B B B B B B B B B B B B B B B B B B B B B B B B B B B B B B B B B B B B B B B B B B B B B B B B B B B B B B B B B B B B B B B B B B B B A A A 
 A A A B B B B B B B B B B B B B B B B B B B B B B B B B B B C B B B B B B B B B B B B B B B B B B B B B B B B B B B B B B B B B B B B B B B B B B B B B B B B B B B B B B B B B B B B B B B B B B B B B B B B B B A A A 
 A A A B B B B B B B B B B B B B B B B B B B B B B B B B B B C B B B B B B B B B B B B B B B B B B B B B B B B B B B B B B B B B B B B B B B B B B B B B B B B B B B B B B B B B B B B B B B B B B B B B B B B B B A A A 
 A A A B B B B B B B B B B B B B B B B B B B B B B B B B B B B C B B B B B B B B B B B B B B B B B B B B B B R B B B B B B B B R B B B B B B B B B B B B B B B B B B B B B B B B B B B B B B B B B B B B B B B B B A A A 
 A A A B B B B B B B B B B B B B B B B B B B B B B B B B B B B C B B B B B B C B B B B B B B B B B B B B B B B B B B B B B B C B B B B B R R B B B B B B B B B B C B B B B B R R B B B B B B B B B B B B B B B B B A A A 
 A A A B B B B B B B B B B B B B B B B B B B B B B B B B B B C C B B B B B C B B B B B B B B B B B B B B B B B B B B B B B B C B B B B B R R B B B B B B B B B C B B B B B B B B B B B B B B B B B B B B B B B B B A A A 
 A A A B B B B B B B B B B B B B B B B B B B B B B B B B B B C C B B B B B C B B B B B B B B B B B B B B B B B B B B B B C C C B B B B B B B B B B B B B B B C B B B B B B B B B B B B B B B B B B B B B B B B B B A A A 
 A A A B B B B B B B B B B B B B R B B C B B B B B C B B B B B B C B B B C B B B B B B B B B B B B B B B B B B B B B C C C C C B B B B B B B B B B B B B B C B B B B B B C B B B B B B B B B B B B B B B B B B B B A A A 
 A A A B B B B B B B B B B B B B R B B C B B B B B C B B B B B B C B B B C B C B B B B B B B C B B B B B B B B C C B C C C C B B B B B B B B B B B B B B C C B B B B C C C B B B B B B B B B B B B B B B B B B B B A A A 
 A A A B B B B B B B B B B B B B B B B C C B B B B C B B B B B C C B B B C C B B B B B B B B B C B B B B B B C C C B C C C C B B B B B B B B B B B C C C C C B B B B C C C B B B B B B B B B B B R B B B B B B B B A A A 
 A A A B B B B B B B B B B B B B B B B C C B B B B C C C B B C C C B B C C C B B B B B B B B B C B B B B B C C C C B C C C C B B B B B B B B B B B C C C C C B B B C C C C B B B B B B B B B B R R R B B B B B B B A A A 
 A A A B B B B B B B B B B B B B B B B C C B B B B B C C B B C C C B B C C C B B B B B B B C B C B B B B C C C C C C C C C C B B B B B C B B B B C C C C C C B B B C C C B B B B B B B B B B B B R B B B B B B B B A A A 
 A A A B B B C B B B B B B B B B B B B C C C C B C C C C B B C C C B B C C C C B B B B B B B C C B B B B C C C C C C C C C C B B B C C B B B C C C C C C C B B B C C C C B B B B B B B B B B B B B B B B B B B B B A A A 
 A A A B B B B C B B B B B B B B C B B C C C C B C C C C B B C C C B B C C C C B B B B B B C C C B B B B C C C C C C C C C C B B B C B B B B C C C C C C C B B B C C C C B B B C B B B B B B B B B B B B B B B B B A A A 
 A A A B B B B C B B B B B B B B C B B C C C C B C C C C B B C C C B B C C C C B B C C B B C C C B B C C C C C C C C C C C C C B C C B B B C C C C C C C C B B C C C C C B B B C C C B B B B B B B B B B B B B B B A A A 
 A A A B B B B B C B B B B B B C B B B B B C C B C C C C B B C C C B B C C C C B B C C C C C C C B B C C C C C C C C C C C C C B C C B C C C C C C C C B B B C C C C C B B B B C C C B B B B B B B B B B B R R B B A A A 
 A A A B B B B B C C B B B B B C B B B B B C C C C C C C B C C C C B B C C C C C B C C C C C C C B C C C C C C C C C C C C C C C C C C C C C C C C C B B B C C C C C C B B B B C C C B B B B B B B B B B B B B B B A A A 
 A A A B B B B B B C C B B B B C B B B B B C C C C C C C B C C C C C B C C C C C B C C C C C C C C C C C C C C C C C C C C C C C C C C C C C C C C C B B B C C C C C C B B B B C C C B B B B C C B B B B B B B B B A A A 
 A A A C C B B B B C C C B B B C B B B B B C C C C C C C C C C C C C C C C C C C C C C C C C C C C C C C C C C C C C E C C C C C C C C C C C C C C C C C C C C C C C C B B B B C C C B B B C C C B B B C C B B C C A A A 
 A A A C C B B B C C C C C C C C B B B B C C C C C C C C C C C C C C C C C C C C C C C C C C C C C C C C C C C C C E N E C C C C C C C C C C C C C C C C C C C C C C C B B B B C C C B B C C C C B B C C C B B C C A A A 
 A A A C C B B B B B C C C C C C B B B B C C C C C C C C C C C C C C C C C C C C C C C C C C C C C C C C C C C C C E N E C C C C C C C C C C C C C C C C C C C C C C C B B B B C C B B B C C C C B B C C C B B C C A A A 
 A A A C C C B B B B B C C C C C C C B B C C C C C C C C C C C C R C C C C C C C C C C C C C C C C C C C C C C C E F N E C C C C C C C C C C C C C C C C C C C C C C C B C B C C C B B C C C B B C C C C C B C C C A A A 
 A A A C C C C C B B B B C C C C C C B C C C C C C C C C C C C R R R C C C C C C C C C C C C C C C C C C C C C E F F N E C C C C C C C C C C C C C C R C C C C C C C C C C C C C C B C C C B B C C C C C C B C C C A A A 
 A A A C C C C C C B B B B B C C C C C C C C C C C C C C C C C C R C C C C C C C C C C C C C C C C C C C C C E F F F N E C C C C C C C C C C C C C C C C C C C C C C C C C C C C C C C C C B B C C C C C C C C C C A A A 
 A A A C C C C C C B B B B B C C C C C C C C C C C C C C C C C C C C C C C D D D D C C C C C C C C C C C C E F F F F N E C C C C C C C C C C C C C C C C C C C C C C C C C C C C C C C C C B B C C C C C C C C C C A A A 
 A A A C C C C C C C C C B B C C C C C C C C C C C C C C C C C C C C C C C D D D D C C C C D D C C C C C C E F F F F N E C C C C C C C C E E E E E E E E E C C C C C C C C C C C C C C C C B C C C C C C C C C B B A A A 
 A A A C C C C C C C C C C C C C C C C C C C C C C C C C D D C C C C C C C D D D D D C C C C D D D D D D E F F F F F N E C C C E E E E E G G G G G G G G G E E E E C C C C C C C C C C C C C C C C C C C C C B B B A A A 
 A A A C C C C C C C C C C C C C C C C C C C C C C C C D D D C C C C C C D D D D D D C C C C D D D D D D E F F F F F N E C C C E G G G G G E E E E E E E E G G G G E E C C C C C C C C C C C C C C C C C C B B B B A A A 
 A A A B C C C C C C C C C C C C D D D D C C C C C C C D D D D C C C C C D D D D D D C C C D D D D D D E F F F F F F N E E E E E G G E E E E E E E E E E E G G G E E E E C C C C C C C C C C C C C C C C C B B B B A A A 
 A A A B C C C C C C C C C C C C D D D D C C C C C C C D D D D D C C C C D D D D C C D C C C C C C C E F F F F F F F N E E E E E E E E E E E E E E E E E E E E G G G E E C C C C C C C C C C C C C C C C B B B B B A A A 
 A A A B C C C C C C C C C C C C C D D D C C C C D D C D D D D D C C D D D D D D D D D D D D D D D E F F F F F F F F N E E E E E E E E E E D D D D D D D D E E E G G G E E C C C C C C C C C C C C C C C B B C C C A A A 
 A A A B C C C C C C C C C C C C C D D D C C C C D D D D D D D D C D D D D D D D D D D D D D D D D E F F F F F F F F N E E E E E E E E D D D D D D D D D D D D E E G G G G E E C C C C C C C C C C C C C B C C C C A A A
 A A A C C C C C C C C C C C C C C D D D D C C D D D D D D D D D D D D D D D D D D D D D D D D D E F F F F F F F F F N N E E E E D D D D D D D D D D D D D D D D E E E G G E E E C C C C C C C C C C C C C C C C C A A A 
 A A A C C C C C C C C C C C C C C D D D D D D D D D D D D D D D D D D D D D D D D D D D D D D D E F F F F F F F F F N N E E D D D D D D D D D E E E E D D D D D D E E E G G E E E C C C C C C C C C C C C C C C C A A A 
 A A A C C C C C C C C C C C C C C D D D D D D D D D D D D D D D D D D D D E E E E E E E E E D E F F F F F F F F F F N N E E D D D D D D E E E F F F E D D D D D D D E E E G G E E E C C C C C C C C C C C C C C C A A A 
 A A A C C C C C C C C C C C C C C D D D D D D D D D D D D D D D D D D E E E E E E E E E E E E E F F F F F F F F F F N N E E D E D D D E F F F F F E D D D D D D D D D D E E G G E E C C C C C C C C C C C C C C C A A A 
 A A A C C E E E E C C C C E E E E D D D D D D D D D D D D D D D D E E G G G G E E G G E E E E F F F F F F F F F F F N N E E E E D E E F F F F N E D D D D D D D D D D D D E E E E E E D D D C C C C C C C C C C C A A A 
 A A A C C E N N N E C C E N N N E D D D D D D D D D D D D D D D E G G G G G E E G G E E E E E F F F F F F F F F F F N N N N E E E F F F F F F E D D D D D D D D D D D D D D E E G E E D D D C C C C C C C C C C C A A A 
 A A A C C E N Q Q Q E E Q Q Q N E D D D D D D D D D D D D D D D E G G G G E G G G E E E E E F F F F F F F F F F F F N F F N E E F F F F F F F E D D D D D D E E E D D D D D D E G E E E D D C C C C C E E E E E C A A A 
 A A A C C E N N Q Q Q Q Q Q N N E D D D D D D D D D D D D D D E G G G G E G G G E E E E E F F F F F F F F F F F F N F F F N E F F F F F F N E D D D D E E E F F E D D D D D D E G E E E E E E E E E E F F F E E C A A A 
 A A A D D D E N Q Q Q Q Q Q N E D D D D D D D D D D D D D D E G G G G E G G G E E E E F F F F F F F F F F F F F F F F F F F F F F F F F N N E D D E E F F F E E D D D D E E E E E G E E E F F F F F F F F N E C C A A A 
 A A A D D D D E N Q Q Q Q N E D D D D D D D D D D D D D D E G G G G E G G G E E E E F F F F F F F F F F F F F F F F F F F F F F F F N N N N E E E F F F F N E D D D E E E F F F F G E E E F F F F F F N N E C C C A A A 
 A A A D D D D E N Q Q Q Q N E D D D D D D D D D D D D D D E G G G G E G G E E E F F F F F F F F F F F F F F F F F F F F F F F F F F F F F F F F F F N N N E D E E E F F F F F F F E G E E F F F F F N N E D D C C A A A 
 A A A D D D E N Q Q Q Q Q Q N E D D D D D D D D D D D D D E G E G E G G E E E F E F F F F F F F F F F F F F F F F F F F F F F F F F F F F F F F F F F N N E E F F F F F F F F F F E G E E F F F F N N N E D D D C A A A 
 A A A D D D E N Q Q Q Q Q Q N E D D D D D D D D D D D D D E E G E E G E F F F F E E F F F F F F F F F F F F F F F F F F F F F F F F F F F F F F F F N E E F F F F F F F F F F F F E G E E F F N N N E E D D D D D A A A 
 A A A D D E E N N N N N N N N E E D D D D D D D D D D D E E E G E E E F F F F E I E F F F F F F F F F F F F F F F F F F F F F F F F F F F F F F F F F F F F F F F F F F F F F F F E G E E E N N N N E D D D D D D A A A 
 A A A D D E E N N N N N N N N E E D D D D D D D D D D D E E E G E E F F F F F E I E E F F F F F F F F F F F F F F F F F F F F F F F F F F F F F F F F F F F F F F F F F F F F F F E G E E E N N N E D D D D D D D A A A 
 A A A D D D D E E E E E E E E D D D D D D D D D D D E E E E E E E F F F F F E H I I E F F F F F F F F F F F F F F F F F F F F F F F F F F F F F F F F F F F F F F F F F F F F F F E G E E E N N E D D D D D D D D A A A 
 A A A D D D D D D D D D D D D D D D D D D D D D E E F F E E E F F F F F F F E H H H I E F F F F F F F F F F F F F F F F F F F F F F F F F F F F F F F F F F F F F F F F F F F N N E G E E E E E D D D D D D D D D A A A 
 A A A D D D D D D D D D D D D D D D D D D D E E F F F F E E F F F F F F F E I H H H I E F F F F F F F F F F F F F F F F F F F F F F F F F F F F F F F F F F F F F F F F F F N N N E G E E E E D D D D D D D D D D A A A 
 A A A C C D D D D D D D D D D D D D D D D E F F F F F F E E F F F F F F F E I H H H I I E F F F F F F F F F F F F F F F F F F F F F F F F F F F F F F F F F F F F F F F F N N N N E E E E E E D D D D D D D D D D A A A 
 A A A C C D D D D D D D D D D D D D D D E F F F F F F F E F F F F F F F F E I H H H H I E F F F F F F F F F F F F F F F F F F F F F F F F F F F F F F F F F F F F F F N N E E E E E E E E E D D D D D D D D D D D A A A 
 A A A D D D D D D D D D D D D D D D E N E F F F F F F E F F F F F F F F F E I H H H H H I E F F F F F F F F F F F F F F F F F F F F F F F F F F F F F F F F F F F F N E E G G G E E E E E E D D D D D D D D D D D A A A 
 A A A D D D D D D D D D D D D D D E N N F F F F F F E E F F F F E F F F F E I H H H H H E E F F F F F F F F F F F F F F F F F F F F F F F F F F F F F F F F F F F E E E G G G G E E E E E E E D D D D D D D D D D A A A 
 A A A D D D D D D D D D D D D D D E N N F F F F F F E F F F F E E F F F F E I H H H H H E I E F F F F F F F F F F F F F F F F F F F F F F F F F F F F F F F F F F E G G G G G E E E E E E E E E D D D D D D D D D A A A 
 A A A D D D D D D D D D D D D D D E N N N N F F F E E F F F F E J E F F F F E H H H H H H I E N N F F F F F F F F F F F F F F F F F F F F F F E E F F F F F F F E G G G K G G E E E E E E E E E E D D D D D D D D A A A 
 A A A D D D D D D D D D D D D D D E N N N N F F F E F F F F F E J E F F F F E H H H H H I I E E F F F F F F F F F F F F F F F F F F F E E E E E E F F F F F F E G G G K K K G G E E E E E E E E E E E E E E D D D A A A 
 A A A D D D D D D D D D D D D D D E N N N N N N E F F F F F F E J J E F F F F E I H H H I I E F F F F F F F F F F F F F F F F E E E E I I I I I E F F F F F F E G K K K K K G G E E E E E E E E E E E E D D D D D A A A 
 A A A D D D D D D D D D D D D D D E N N N N N N E F F F F F E J J J J E F F F F E E I I I E F F F F F F F F F F F E E E E E E I I H H H H H I E F F F F F F E G G K K K K K G G E E E E E E E E E E E E D D D D D A A A 
 A A A D D D D D D D D D D D D D D D E N N N N E F F F F F F E J J J J E F F F F F F E E E F F F F F F F F E E E E I I E E I H H H H H H H H I E F F F F F F E G K K K K K K G E E L L L L L L L E E P E E E E E E A A A 
 A A A D D D D D D D D D D D D D D D E N N N E F F F F F F F E J J J E J E F F F F F F F F F F F F F F F F F E I H H H E H H H H H H H H H H E F F F F F F E G G K G G K K G E E L L L M M M M L L E P P P P P P P A A A 
 A A A D D D D D D D D D D D D D D D D E N N E F F F F F F F E J J J E J J E E F F F F F F F F F F F F F F F E I H H H H H H H H H H H H I E F F F F F F F E G G K G G K K G E E M L M L L L L M L E P P P P P P P A A A 
 A A A D D D D D D D D D D D D D D D D E E N E F F F F F F F E J J E J J J J J E E F F F F F F F F F F F F F E I H H H H H H H H H H H E E F F F F F F F F E G G K G G K E E E M M L M L L L L M L E P P P P P P P A A A 
 A A A D D D D D D D D D D D D D D D D E E E F F F F F F F F E J J E J J J J J J E E F F F F F F F F F F F F F E I H H H H H H H H H E F F F F F F F F F F E G G K G G K K E E M L L M L L L L M L E P P P P P P P A A A 
 A A A D D E E D D E E D D D D D D D D D D E F F F F F F F F E J J E J J J J J J E J E F F F F F F F F F F F F E E E I I I I I I E E F F F F F F F F F F F E G G G G G G G E E M L L M L L L L M L E P P P P P P P A A A 
 A A A D D E R D D E R D D D D D D D D E E F F F F F F F F F F E J E J J J J J J E J J E E F F F F F F F F F F F F F E E E E E E F F F F F F F F F F F F F E G E G G G G E E E M L L M L L L L M L E P P P P P P P A A A 
 A A A D D E R E E E R E E E D D D D D D E F F F F F F F F F F E E J J J J J J J E J J J J E E E F F F F F F F F F F F F F F F F F F F F F F F F F F F F F E G E G G G G E E E M L L M L L L L M L E P P P P P P P A A A 
 A A A E R E E F F E E F F F E E E E E E E F F F F F F F F F F F E J J J J J J E J J J J J J J J E E F F F F F F F F F F F F F F F F F F F E E F F F F F F E G E G G G G G E E M L L M L L L L M L E P P P P P P P A A A 
 A A A E R E E F F F E F F F F F F F F F E E F F F F F F F F F F E J J J J J J E J J J J J J J J J E E E E E F F F F F F F F F F F F F E E E F F F F F F F E E E E E E G E E E M L L M L L L L M L E P P P P P P P A A A 
 A A A E E E N N F F E F F F F F F F F F F E F F F F F F F F F F F E J J J J J E J J J J J J J J J E J J J J E E E E E E E E E E E E E J J E F F F F F F F E E E E E E E E E E L L L M L L M M L E P P P P P P P P A A A 
 A A A D E E N N F F E F F F F F F F F F F F E F F F F F F F F F F F E J J J E J J J J J J J J J E J J J J J J J J J E J J J J J J E J J E F F F F F F F F N E E E E E E E E E E L L L M M L L L E P P P P P P P P A A A 
 A A A D E E N N F F E F F F F F F F F F F F F E F F F F F F F F F F F E J J E J J J J J J J J J E J J J J J J J J J E J J J J J J E J E F F F F F F F F F N E E E E E E E E E E L L L L L L L E E P P P P P P P P A A A 
 A A A D E E N N F F E F F F F F F F F F F F F E F F F F F F F F F F F F E J E J J J J J J J J J E J J J J J J J J E J J J J J J J E E F F F F F F F F F F N N E E E E E E E E E E E L L L L L E P P P P P P P P P A A A 
 A A A D E N N N F F F F F F F F F F F F F F F E F F F F F F F F F F F F F E E J J J J J J J J E J J J J J J J J J E J J J J J J J E F F F F F F F F F F F N N E E E E E E E E E E E E E E E E E P P P P E E E E E A A A 
 A A A D E N N N N N F F F F F F F F F F F F F F E F F F F F F F F F F F F F F E E J J J J J J E J J J J J J J J J E J J J J J E E F F F F F F F F F F F F F N N E E E E E E E E E E E E E E E P P P P P E D D D D A A A 
 A A A D E N N N N N N N N N F F F F F F F F F F E F F F F F F F F F F F F F F F F E E J J J J E J J J J J J J J E J J J J E E F F F F F F F F F F F F F F F F N N E E E E E E E E E E E E E P P P P P P E D D D D A A A 
 A A A D E N N N N N N N N N N F F F F F F F F F E F F F F F F F F F F F F F F F F F F E E E E E E J J J J J J J E J J J E F F F F F F F F F F F F F F F F F F F N N N N E E E E E E E E P P P P P P E E D D D D D A A A 
 A A A D E N N N N N N N N N N N F F F F F F F F E F F F F F F F F F F F F F F F F F F F F F F F F E E E E E E E E E E E F F F F F F F F F F F F F F F F F F F F N N N N E E E E E E E E P P P P P E D D D D D D D A A A 
 A A A D E N N N N O O O O N N N F F F F F F F F E F F F F F F F F F F F F F F F F F F F F F F F F F F F F F F F F F F F F F F F F F F F F F F F F F F F F F F F F N N N N N N N N E E E P P P P E D D D D D D D D A A A 
 A A A D E N N N O O O O O O N N N F F F F F F F E F F F F F F F F F F F F F F F F F F F F F F F F F F F F F F F F F F F F F F F F F F F F F F F F F F F F F F F F F N N N N N N N N E E P P P P E D D D D D D D D A A A 
 A A A D E N N N O O O O O O O N N N F F F F F F E F F F F F F F F F F F F F F F F F F F F F F F F F F F F F F F F F F F F F F F F F F F F F F F F F F F F F F F F F F N N N N N N N N E P P P P P E E D D D D D D A A A 
 A A A D D E N N O O O O O O O O N N F F F F N N E F F F F F F F F F F F F F F F F F F F F F F F F F F F F F F F F F F F F F F F F F F F F F F F F F F F F F F F F F F F N N N N N N N E P P P P P P E D D D D D D A A A