 A A A A A A A A A A A A A A A A A A A A A A A A A A A A A A A A A A A A A A A A A A A A A A A A A A A A A A A A A A A A A A A A A A A A A A A A A A A A A A A A A A A A A A A A A A A A A A A A A A A A A A A A A A A A 
 A A A A A A A A A A A A A A A A A A A A A A A A A A A A A A A A A A A A A A A A A A A A A A A A A A A A A A A A A A A A A A A A A A A A A A A A A A A A A A A A A A A A A A A A A A A A A A A A A A A A A A A A A A A A 
 A A A A A A A A A A A A A A A A A A A A A A A A A A A A A A A A A A A A A A A A A A A A A A A A A A A A A A A A A A A A A A A A A A A A A A A A A A A A A A A A A A A A A A A A A A A A A A A A A A A A A A A A A A A A 
 A A A A A A A A A A A A A A A A A A A A A A A A A A A A A A A A A A A A A A A A A A A A A A A A A A A A A A A A A A A A A A A A A A A A A A A A A A A A A A A A A A A A A A A A A A A A A A A A A A A A A A A A A A A A 
 A A A A B B B B B B B B B B B B B B B B B B B B B B B B B B B B B B B B B B B B B B B B B B B B B B B B B B B B B B B B B B B B B B B B B B B B B B B B B B B B B B B B B B B B B B B B B B B B B B B B B B B B A A A A 
 A A A B B B B B B B B B B B B B B B B B B B B B B B B B B B B B B B B B B B B B B B B B B B B B B B B B B B B B B B B B B B B B B B B B B B B B B B B B B B B B B B B B B B B B B B B B B B B B B B B B B B B B B A A A 
 A A A B B B B B B B B B B B B B B B B B B B B B B B B B B B B B B B B B B B B B B B B B B B B B B B B B B B B B B B B B B B B B B B B B B B B B B B B B B B B B B B B B B B B B B B B B B B B B B B B B B B B B B A A A 
 A A A B B B B B B B B B B B B B B B B B B B B B B B B B B B B B B B B B B B B B B B B B B B B B B B B B B B B B B B B B B B B B B B B B B B B B B B B B B B B B B B B B B B B B B B B B B B B B B B B B B B B B B A A A 
 A A A B B B B B B B B B B B B B B B B B B B B B B B B B B B B B B B B B B B B B B B B B B B B B B B B B B B B B B B B B B B B B B B B B B B B B B B B B B B B B B B B B B B B B B B B B B B B B B B B B B B B B B A A A 
 A A A B B B B B B B B B B B B B B B B B B B B B B B B B B B C B B B B B B B B B B B B B B B B B B B B B B B B B B B B B B B B B B B B B B B B B B B B B B B B B B B B B B B B B B B B B B B B B B B B B B B B B B A A A 
 A A A B B B B B B B B B B B B B B B B B B B B B B B B B B B C B B B B B B B B B B B B B B B B B B B B B B B B B B B B B B B B B B B B B B B B B B B B B B B B B B B B B B B B B B B B B B B B B B B B B B B B B B A A A 
 A A A B B B B B B B B B B B B B B B B B B B B B B B B B B B B C B B B B B B B B B B B B B B B B B B B B B B R B B B B B B B B R B B B B B B B B B B B B B B B B B B B B B B B B B B B B B B B B B B B B B B B B B A A A 
 A A A B B B B B B B B B B B B B B B B B B B B B B B B B B B B C B B B B B B C B B B B B B B B B B B B B B B B B B B B B B B C B B B B B R R B B B B B B B B B B C B B B B B R R B B B B B B B B B B B B B B B B B A A A 
 A A A B B B B B B B B B B B B B B B B B B B B B B B B B B B C C B B B B B C B B B B B B B B B B B B B B B B B B B B B B B B C B B B B B R R B B B B B B B B B C B B B B B B B B B B B B B B B B B B B B B B B B B A A A 
 A A A B B B B B B B B B B B B B B B B B B B B B B B B B B B C C B B B B B C B B B B B B B B B B B B B B B B B B B B B B C C C B B B B B B B B B B B B B B B C B B B B B B B B B B B B B B B B B B B B B B B B B B A A A 
 A A A B B B B B B B B B B B B B R B B C B B B B B C B B B B B B C B B B C B B B B B B B B B B B B B B B B B B B B B C C C C C B B B B B B B B B B B B B B C B B B B B B C B B B B B B B B B B B B B B B B B B B B A A A 
 A A A B B B B B B B B B B B B B R B B C B B B B B C B B B B B B C B B B C B C B B B B B B B C B B B B B B B B C C B C C C C B B B B B B B B B B B B B B C C B B B B C C C B B B B B B B B B B B B B B B B B B B B A A A 
 A A A B B B B B B B B B B B B B B B B C C B B B B C B B B B B C C B B B C C B B B B B B B B B C B B B B B B C C C B C C C C B B B B B B B B B B B C C C C C B B B B C C C B B B B B B B B B B B R B B B B B B B B A A A 
 A A A B B B B B B B B B B B B B B B B C C B B B B C C C B B C C C B B C C C B B B B B B B B B C B B B B B C C C C B C C C C B B B B B B B B B B B C C C C C B B B C C C C B B B B B B B B B B R R R B B B B B B B A A A 
 A A A B B B B B B B B B B B B B B B B C C B B B B B C C B B C C C B B C C C B B B B B B B C B C B B B B C C C C C C C C C C B B B B B C B B B B C C C C C C B B B C C C B B B B B B B B B B B B R B B B B B B B B A A A 
 A A A B B B C B B B B B B B B B B B B C C C C B C C C C B B C C C B B C C C C B B B B B B B C C B B B B C C C C C C C C C C B B B C C B B B C C C C C C C B B B C C C C B B B B B B B B B B B B B B B B B B B B B A A A 
 A A A B B B B C B B B B B B B B C B B C C C C B C C C C B B C C C B B C C C C B B B B B B C C C B B B B C C C C C C C C C C B B B C B B B B C C C C C C C B B B C C C C B B B C B B B B B B B B B B B B B B B B B A A A 
 A A A B B B B C B B B B B B B B C B B C C C C B C C C C B B C C C B B C C C C B B C C B B C C C B B C C C C C C C C C C C C C B C C B B B C C C C C C C C B B C C C C C B B B C C C B B B B B B B B B B B B B B B A A A 
 A A A B B B B B C B B B B B B C B B B B B C C B C C C C B B C C C B B C C C C B B C C C C C C C B B C C C C C C C C C C C C C B C C B C C C C C C C C B B B C C C C C B B B B C C C B B B B B B B B B B B R R B B A A A 
 A A A B B B B B C C B B B B B C B B B B B C C C C C C C B C C C C B B C C C C C B C C C C C C C B C C C C C C C C C C C C C C C C C C C C C C C C C B B B C C C C C C B B B B C C C B B B B B B B B B B B B B B B A A A 
 A A A B B B B B B C C B B B B C B B B B B C C C C C C C B C C C C C B C C C C C B C C C C C C C C C C C C C C C C C C C C C C C C C C C C C C C C C B B B C C C C C C B B B B C C C B B B B C C B B B B B B B B B A A A 
 A A A C C B B B B C C C B B B C B B B B B C C C C C C C C C C C C C C C C C C C C C C C C C C C C C C C C C C C C C E C C C C C C C C C C C C C C C C C C C C C C C C B B B B C C C B B B C C C B B B C C B B C C A A A 
 A A A C C B B B C C C C C C C C B B B B C C C C C C C C C C C C C C C C C C C C C C C C C C C C C C C C C C C C C E N E C C C C C C C C C C C C C C C C C C C C C C C B B B B C C C B B C C C C B B C C C B B C C A A A 
 A A A C C B B B B B C C C C C C B B B B C C C C C C C C C C C C C C C C C C C C C C C C C C C C C C C C C C C C C N N E C C C C C C C C C C C C C C C C C C C C C C C B B B B C C B B B C C C C B B C C C B B C C A A A 
 A A A C C C B B B B B C C C C C C C B B C C C C C C C C C C C C R C C C C C C C C C C C C C C C C C C C C C C C E F N E C C C C C C C C C C C C C C C C C C C C C C C B C B C C C B B C C C B B C C C C C B C C C A A A 
 A A A C C C C C B B B B C C C C C C B C C C C C C C C C C C C R R R C C C C C C C C C C C C C C C C C C C C C E F F N E C C C C C C C C C C C C C C R C C C C C C C C C C C C C C B C C C B B C C C C C C B C C C A A A 
 A A A C C C C C C B B B B B C C C C C C C C C C C C C C C C C C R C C C C C C C C C C C C C C C C C C C C C E F F F N E C C C C C C C C C C C C C C C C C C C C C C C C C C C C C C C C C B B C C C C C C C C C C A A A 
 A A A C C C C C C B B B B B C C C C C C C C C C C C C C C C C C C C C C C D D D D C C C C C C C C C C C C E F F F F N E C C C C C C C C C C C C C C C C C C C C C C C C C C C C C C C C C B B C C C C C C C C C C A A A 
 A A A C C C C C C C C C B B C C C C C C C C C C C C C C C C C C C C C C C D D D D C C C C D D C C C C C C E F F F F N E C C C C C C C C E E E E E E E E E C C C C C C C C C C C C C C C C B C C C C C C C C C B B A A A 
 A A A C C C C C C C C C C C C C C C C C C C C C C C C C D D C C C C C C C D D D D D C C C C D D D D D D E F F F F F N E C C C E E E E E G G G G G G G G G E E E E C C C C C C C C C C C C C C C C C C C C C B B B A A A 
 A A A C C C C C C C C C C C C C C C C C C C C C C C C D D D C C C C C C D D D D D D C C C C D D D D D D E F F F F F N E C C C E G G G G G E E E E E E E E G G G G E E C C C C C C C C C C C C C C C C C C B B B B A A A 
 A A A B C C C C C C C C C C C C D D D D C C C C C C C D D D D C C C C C D D D D D D C C C D D D D D D E F F F F F F N E E E E E G G E E E E E E E E E E E G G G E E E E C C C C C C C C C C C C C C C C C B B B B A A A 
 A A A B C C C C C C C C C C C C D D D D C C C C C C C D D D D D C C C C D D D D C C D C C C C C C C E F F F F F F F N E E E E E E E E E E E E E E E E E E E E G G G E E C C C C C C C C C C C C C C C C B B B B B A A A 
 A A A B C C C C C C C C C C C C C D D D C C C C D D C D D D D D C C D D D D D D D D D D D D D D D E F F F F F F F F N E E E E E E E E E E D D D D D D D D E E E G G G E E C C C C C C C C C C C C C C C B B C C C A A A 
 A A A B C C C C C C C C C C C C C D D D C C C C D D D D D D D D C D D D D D D D D D D D D D D D D E F F F F F F F F N E E E E E E E E D D D D D D D D D D D D E E G G G G E E C C C C C C C C C C C C C B C C C C A A A